6 0 7 0 7 0 3
0 0 0 0 0 0 0
10 0 10 0 7 0 9
0 0 0 0 0 0 0
10 0 8 0 9 0 9
0 0 0 0 0 0 0
5 0 8 0 8 0 4